13
12
#############
#m#........##
#...........#
#######.....#
#..#..#.....#
#..#.##.....#
#...........#
#.#.#######.#
#.#....p..#.#
#.#########.#
#...........#
#############